"a" = (/turf/standart/floor,/area)
"b" = (/turf/standart/wall,/area)
"c" = (/obj,/turf/standart/floor,/area)

(1,1,1) = {"
aaaaaaaaaa
aaaaaaaaaa
aaaaaaaaaa
aabbbbbaaa
aabaaabaaa
aabacabaaa
aabaaabaaa
aabbabbaaa
aaaaaaaaaa
aaaaaaaaaa
"}
